R  1080 720
NO ./textures/wall_n.xpm
SO ./textures/wall_s.xpm
WE ./textures/wall_w.xpm
EA ./textures/wall_e.xpm

S ./textures/barrel.xpm
F 224,172,105
C 205,249,255

11111111111
10000000001
10000000001
10202020201
1000000000111111
1000000000000001
1000000000111111
10000N00001
10000000001
11111111111
