R  1000 1000
NO ./textures/redbrick.xpm
SO ./textures/bluestone.xpm
WE ./textures/wood.xpm
EA ./textures/greystone.xpm

S ./textures/barrel.xpm
F 255, 255, 255
C 0, 0, 0

1111111111
1000000001
100000N001
1000000001
1000000001
1000000001
1000000001
1000000001
1111111111
